 X    XXXXXXXXXXXXXXXXXXXXXXXXXXX
XX    X          X               
      X          X        XXXXXXX
      X   X             X XXXX XX
      X X X X X X X X X X X      
      X                   X      
      X      X     X X X  X      
  X   X  X X X X X X X X XX      
  X   X                   X      
      X   X X             X      
      X X X X X X X X X X X      
      X                   X      
      X  X     X X     X  X      
      X  X X X X X X X X XX      
      X                   X      
 X    X        X  X       X      
 X    XXXXXXXXXX  XXXXXXXXX      
                          X      
                          X      
                          X      
