                          XXXX  X
                          XX  X X
                          XXX XXX
XXXXXXXXXXXXXXXX   XXXXXXXXX  X  
XXXXXXXXXXXXXXXX   XXXXXXXXXX X X
XXXXXXXXXXXXXXXX   XXXXXXXX    X 
                               X 
                            XX  X
          X                   X X
  X       X            XXXX     X
  X              X     XXXX    X 
                 X     XXXX   X  
                               X 
                                X
                                 
               X                 
               X                 
    X                         X  
    X                         X  
                                 
