               XXXXXXXXX         
        XXXXXXXXXXXXXXXX       XX
     XXXXXXXXXXXXXXXXXXX XX   X  
     XXXXXXXXXXXXXXXXXXX XX  X   
    XX XXXXXXXXXXXXXXXXX     X   
    X             X X      XX    
    X    XXX            X  X     
        XXXXXX          X  X     
        XXXXXX XX          X  X  
        XXXXX  XX   X      X  X  
        XXXXX       X      X  X  
     X  XXXXX       X         X  
     X                        X  
                              X  
                              X  
                     XX      X   
                     XX  X   X   
                         X   X   
                            X    
                            X    
