XXXXXXXXXXXXXXXX   XXXX      XXXX
XXXXXXXXXXXXXXXX  XXXXX    XXXXXX
XXXXXXXXXXXXXXX  XXXXXX    XXXXXX
XXXXXXX XXXXXX  XXXXXX     XXXXXX
XXXXXX         XXXXXXX    XXXXXXX
XXXXXX  X     XXXXXXXX    XXXXXXX
XXXXXX XX     XXXXXXXX   XXXXXXXX
XXXX   XX     XXXXXXXX   XXXXXXXX
XXX   XXX      XXXXXXX   XXXXXXXX
XX  XXXXX        XXXXX   XXXXXXXX
XX  XXXX   XX    XXXXX   XXXXXXXX
XX  XXX   XXXX     XXX   XXXXXXXX
XXX XXX  XXXXXX     X      XXXXXX
XXXXXX  XXXXXXXXX             XXX
XXXXX   XXXXXXXXXX    XXXXX      
XXXXXXXXXXXXXXXXXX    XXXXXXXXXXX
XXXXXXXXXXXXXXXXXX   XXXXXXXXXXXX
XXXXXXXXXXXXXXXXX    XXXXXXXXXXXX
XXXXXXXXXXXXXXXX    XXXXXXXXXXXXX
XXXX   XXXXXXXXX   XXXXXXXXXXXXXX
