XXXXXXXXXXXXXXXXXX               
XXXXXXXXXXXXXXXXXX               
XXXXXXXXXXXXXXXXXX               
XXXXXXXXXXXXXXXXX          X     
XXXXXXXXXXXXXXXXX          X     
XXXXXXXXXXXXXXXX                 
XXXXXXXXXXXXXXX                  
XXXXXXXXXXXXXXX     X            
XXXXXXXXXXXXXX      X       X    
XXXXXXXXXXXXX               X    
XXXXXXXXXXXX                     
XXXXXXXXXXX                      
XXXXXXXXXX X                     
XXXXXXXXXX X                     
XXXXXXXXXX                       
XXXXXXXXX                  X     
XXXXXXXX                   X     
XXXXXXXX          X              
XXXXXXXX          X              
XXXXXXX                          
