XXXXXXXXXXXXXXXXXXXXXXXXXXXXXXXXX
XXXXXXXXXXXXXXXXXXXXXXXXXXXXXXX  
 XXXXXXXXXXXXXXXXXXXXXXXXXXXXXX  
 X       X      XXXXXXXXXXXXXXX  
                 XXXXXXXX    XX  
                         XX X    
                            X    
                           X     
                          XX     
   X                     X       
   X                    XX       
                       X         
              X       XX         
       X      X       X          
     X X              X          
     XX               X   X      
      XX              X   X      
     X X              X   X      
     XX  X                X      
      X  X                X      
