XXXXXXX  XXXXXX   XXXXXXXXXXXXXXX
XXXXXXXX XXXXXX XXXXXXXXXXXXXXXXX
XXXXXXXXX    XXXXXXXXXXXXXXXXXXXX
XXXXXXXXXX   XXXXXXXXXXXXXXXXXXXX
XXXXXXXXXXX     XXXXX XXXXXXXXXXX
XXXXXXXXXXXX       X     XXXXXXXX
XXXXXXXXXXXXX             XXXXXXX
XXXXXXXXXXXXX                XXXX
XXXXXXXXXXXXX                XXXX
XXXXXXXXXXXXX                XXXX
XXXXXXXXXXXX                 XXXX
XXXXXXXXXXXX                 XXXX
XXXXXXXXXXXX                 XXXX
XXXXXXXXXXX                  XXXX
XXXXXXXXXXX                  XXXX
XXXXXXXXXXX                 XXXXX
XXXXXXXX                  XXXXXXX
XXXXXXX               XXXXXXXXXXX
XXXXXX              XXXXXXXXXXXXX
XXXXX            XXXXXXXXXXXXXXXX
