XXX            XXXXXXXXXXXXXXXXXX
XXX           XXXXXXXXXXXXXX    X
XXXX          XXXXXXXXXXX        
XXX          XXXXXXXXXX          
XXX          XXXXXXXXXX      XXX 
XXXXX        XXXXXXXXXX      XXX 
XXXX         XXXXXXXXXX      XXX 
XXXXX X      XXXXXXXXXX      XXX 
XXXXXXXXX     XXXXXXXXXXX    XXX 
XXXXXXXXXX     XXXXXXXXXX        
XXXXXXXXXXX    XXXXXXXXXXXX      
XXXXXXXXXXX     XXXXXXXXXXXXX    
XXXXXXXXXXX     XXXXXXXXXXXXXXXXX
XXXXXXXXXXXX     XXXXXXXXXXXXXXXX
XXXXXXXXXXXXX      XXXXXXXXXXXXXX
XXXXXXXXXXXXXX         XXXXXXXXXX
XXXXXXXXXXXXXXX            XXXXXX
XXXXXXXXXXXXXXXX             XXXX
XXXXXXXXXXXXXXXXX        X       
XXXXXXXXXXXXXXXX         X       
