XXXXXXXXXXXXXXXXXXXXXXXXXXXXXXXXX                                 
XXXXXXXXXXXXXXXXXXXXXXXXXXXXXXXXX                                 
XXXXXXXXXXXXXXXXXXXXXXXXXXXXXXXXX                                 
XX                   XXXXXXXXXXXX 
XXX    XXX    XXX            XXXX        
X      XXX    XXX    XXXXXXXXXXXX       
XXXXXXXXXX           XXXXXXXXXXXX              
XXXXXXXXXX           XXXXXXXXXXXX        
XXXXXXXXXX           XXXXXXXXXXXX     
XXXXXXXXXX           XXXXXXXXXXXX     
XXXXXXXXXX                   XXXX     
XXXXX  XXX                   XXXX        
XXXXX  XXX               XXX XXXX       
X                            XXXX     
X      XXX               XXX XXXX        
X      XXX                   XXXX        
X      XXX                   XXXX        
XXXXXXXXXXXXXXX XXXXXXXXXXXXXXXXX                          
XXXXXXXXXXXXXXX XXXXXXXXXXXXXXXXX                      
XXXXXXXXXXXXXXX XXXXXXXXXXXXXXXXX                          
