XXXXXXXXXXXXXXXXXXXXXXXXXXXXXXXXX                                 
XXXXXXXXXXXXXXXXXXXXXXXXXXXXXXXXX                                
XXXXXXXXXXXXXXXXXXXXXXXXXXXXXXXXX                                 
XXXXXXXXXXXXXXXXXXXXXXXXXXXXXXXXX              
XXXX                XXX  XXXXXXXX              
XXXX                XXX  XXXXXXXX           
XXXX  X                  XXXXXXXX           
XXXX  X                  XXXXXXXX           
XXXX                     XXXXXXXX           
XXXX                     XXXXXXXX           
XXXX                     XXXXXXXX           
XXXXXXXXXXXXXXXX         XXXXXXXX           
XXXXXXXXXXXXXXXX         XXXXXXXX           
XXXXXXXXXXXXXXXX         XXXXXXXX           
XXXXXXXXXXXXXXXX         XXXXXXXX           
XXXXXXXXXXXXXXXX         XXXXXXXX           
XXXXXXXXXXXXXXXXXXXX XXXXXXXXXXXX           
XXXXXXXXXXXXXXXXXXXX XXXXXXXXXXXX           
XXXXXXXXXXXXXXXXXXXX XXXXXXXXXXXX           
XXXXXXXXXXXXXXXXXXXXXXXXXXXXXXXXX                                 
