XXXXXXXXXXXXXXXXXXXXXXXXXXXXXXXXX
XXXXXXXXXXXXXXXXXXXXXXXXXXXXXXXXX
XXXXXXXXXXXXXXXXXXXXXXXXXXXXXXXXX                                 
XXXXXXXXXXXXXXXXXXXXXXXXXXXXXXXXX                                 
XXXXX        XXXXXXXXXXXXXXXXXXXX            
XXXXX  X     X      X     XXXXXXX            
XXXXX        XXXXXXXXXXXXXXXXXXXX            
XXXXX  X                  XXXXXXX            
XXXXX     X               XXXXXXX            
XXXXX  X                  XXXXXXX            
XXXXX XXX     XXXXX  XXXXXXXXXXXX                      
XXXXX  X  X   XXXXX  XXXXXXXXXXXX                  
XXXXX         XXXXX  XXXXXXXXXXXX                      
XXXXX  X      XXXXXXXXXXXXXXXXXXX                        
XXXXX     X   XXXXXXXXXXXXXXXXXXX                        
XXXXX         XXXXXXXXXXXXXXXXXXX                         
XXXXXXXXXXXXXXXXXXXXXXXXXXXXXXXXX                                 
XXXXXXXXXXXXXXXXXXXXXXXXXXXXXXXXX                                 
XXXXXXXXXXXXXXXXXXXXXXXXXXXXXXXXX                                 
XXXXXXXXXXXXXXXXXXXXXXXXXXXXXXXXX                                 
