XXXXXXXXXXXXXXXXXXXXXXXXXXXXXXXXX
XXXXXXXXXXXXXXXXXXXXXXXXXXXXXXXXX
XXXXXXXXXXXXXXXXXXXXXXXXXXXXXXXXX
XXXXXXX                 X      XX
X        X              X      XX
X        X              X      XX
X        X                     XX
X        X              X X    XX
X        X XXX          X X    XX
X        X XXX          XXXX   XX
X        X            XXXXXXXXXXX
XXXXXXXXXX            XXXXXXXXXXX
XXXXXXXXXX            XXXXXXXXXXX
XXXXXXXXXX            XXXXXXXXXXX
XXXXXXXXXX            XXXXXXXXXXX
XXXXXXXXXXXXXXX XXXXXXXXXXXXXXXXX
XXXXXXXXXXXXXXX XXXXXXXXXXXXXXXXX
XxXXXXXXXXXXXXX XXXXXXXXXXXXXXXXX
XXXXXXXXXXXXXXXXXXXXXXXXXXXXXXXXX
XXXXXXXXXXXXXXXXXXXXXXXXXXXXXXXXX
